111111111111111111111111111111111111111111111111111111111111
1P1000000000000000000000C100000000110000000C1010000000010001
10101111110111111011111111C111111110011110111000101111110101
100010001001C00000000000000001C00100110000100011100000010101
11101C101011011110101011111111101101100111101110111111110101
100011100001010000101000001000100001000100000000000000000101
101110111101011101101101101010110111101101110111111111111101
101C10001C010001010001001000100001000010001C0000001C10000001
1010111011111101011101111111110111110000101011111010001001C1
100000100001000100010000000001000001110111111C10101101110111
111110111001011111011110111101111111010100010010100001010001
1000101C1100010000000010100101000010011101010000111111011101
1010000001111101111C10101011110110100001010101101C000000C101
101110111100000000111010000001001000100001000010000101111101
1000111C00011111111C1010111101101111111101111111111101010101
11100010101100000000101000010C1000000001010000C1C00000010101
1C1111101110011111111010101111100011110101001111110111110101
10100000C10011000000001010000100111C01010110000001010000C101
101111111101100011111110111101000010000100111111010101111101
10000000000100101000010001C100000111110110101010000101C00001
111101111111011011110110110101011100010C10100011111101011101
100001C00000001000000C10100101000000111110111010000001010001
10111110011100111111111010110111111001000000101011011101C101
100000001101101C010000100010010000101110101010100101C0011101
111111111000101101011C11101011010110000010101011110111010101
10001000001C100001001110001010010100111010101000100001000101
101010110111111111011C10111011010001101111100010001011111111
101000C100000000000010101000100111110000000010101110100011E1
1011111111111111111110101011101100000111111111111C1110111001
1000000000000000000000001C00001C0101000000000000000000000011
111111111111111111111111111111111111111111111111111111111111